NO 			./textures/bluestone.xpm
SO ./textures/greystone.xpm
WE 	./textures/eagle.xpm
EA ./textures/redbrick.xpm
C 26,67,2
F 71,19,0000021


111111111111111111111111111111111111
100000000000000000000000000000000001
100000000000000000000000000000000001    11111111111
100000000000000000000000000000000001    1000E000011
100000000000000000000000000000000001    11111111111
100000000000000000000000000000000001
100000000000000000000000000000000001
100000000000000000000000000000000001
111111111111111111111111111111111111
11111111111
10000000011
11111111111