NO 			./textures/bluestone.xpm


		 	 	 	 	 	 	 	 	                  SO ./textures/greystone.xpm
WE 	./textures/eagle.xpm
EA ./textures/redbrick.xpm
C 65,240,25
F 71,19,0000021

1
1	    
11111111111111111111111111111111111
111111D1111111111111111111111111111
11111DSD111111111111111111111111111
111111D1111111111111111111111111111
11111111111111111111111111111111111
