         F              51    ,   198,74
NO textures/wall_1.xpm
           SO textures/wall_2.xpm      
EA                      textures/wall_4.xpm   
C 184,113,39      
WE textures/wall_3.xpm

                                
        111111111111111111111111111
        10000000001100000000110000001
        10110000011100000001111011111
        11111111110000000001110000011111
                10110000011   1000000000111111
                1000000000111100011111111111
        11111111111111011100000010001
        11110111111111011101010010001         11111111
        1100000011010101110000001000D         1001W001
        11111111000000001100000010001         111111111
               10000000000000001100011111111
            11110000110101010000000011111
        111111111101010000000000001111
        10000000001100000101010010011
        10000000000000000000000001001
        10000000111100010000000001001
        100000001   1001101011100000011
        10000000111110000001 10100000001
        11111111111111111111 1111111111